##############??##############
#                            #
#                            #
#                            #
#                            #
#                            #
#                            #
#                            #
#                            #
#                            #
#                            #
#                            #
#                            #
#                            #
?                            ?
?                            ?
#                            #
#                            #
#                            #
#                            #
#                            #
#                            #
#                            #
#                            #
#                            #
#                            #
#                            #
#                            #
#                            #
##############??##############
Est :
Sud :
Ouest :
Nord :